Aal	MEAT
Aalsuppe	MEAT
Absinth	BEVERAGE
Acerolakirsche	FRUIT
Acidophilusmilch	MILK
Ackersalat	VEGE
Agavensirup	SPICE
Ahornsirup	SPICE
Aioli	SPICE
Ajvar	SPICE
Akazienhonig	SWEET
Ale	BEVERAGE
Alfalfa	GRAIN
Alge	VEGE
Alkohol	BEVERAGE
Alt	BEVERAGE
Altbier	BEVERAGE
Amaranth	GRAIN
Amaretto	BEVERAGE
Amerikaner	SWEET
Ananas	FRUIT
Anis	SPICE
Anistee	BEVERAGE
Aperitif	BEVERAGE
Apfel	FRUIT
Apfeldicksaft	BEVERAGE
Apfelessig	SPICE
Apfelessigwasser	SPICE
Apfelgelee	FRUIT
Apfelkompott	FRUIT
Apfelkorn	BEVERAGE
Apfelkuchen	SWEET
Apfelmost	BEVERAGE
Apfelmus	FRUIT
Apfelring	SWEET
Apfel-Rotkohl	VEGE
Apfelsaft	BEVERAGE
Apfelschnaps	BEVERAGE
Apfelschorle	BEVERAGE
Apfelsine	FRUIT
Apfeltasche	SWEET
Apfeltee	BEVERAGE
Apfeltorte	SWEET
Apfelwein	BEVERAGE
Appenzeller	MILK
Aprikose	FRUIT
Aprikosenkompott	FRUIT
Aprikosenkonfitüre	SWEET
Aprikosennektar	BEVERAGE
Aprikosensaft	BEVERAGE
Aprikosenschnaps	BEVERAGE
Aprikosensoße	SPICE
Aprikosentorte	SWEET
Arborio-Reis	STARCH
Aroma	SPICE
Aroniabeere	FRUIT
Artischocke	VEGE
Artischockenherz	VEGE
Artischockensaft	BEVERAGE
Asbach-Cola	BEVERAGE
Aspartam	SPICE
Aubergine	VEGE
Aufbackbrötchen	STARCH
Augenbohne	VEGE
Auslese	BEVERAGE
Auster	MEAT
Austernpilz	VEGE
Auszugsmehl	GRAIN
Averna	BEVERAGE
Avocado	VEGE
Ayvar	SPICE
Babysaft	BEVERAGE
Backfisch	MEAT
Backkartoffel	STARCH
Backmalz	GRAIN
Bacon	MEAT
Baconstreifen	MEAT
Bagel	STARCH
Baguette	STARCH
Baguettebrötchen	STARCH
Baiser	SWEET
Balsamessig	SPICE
Balsamico	SPICE
Banane	FRUIT
Bananenbrot	STARCH
Bananencreme	SWEET
Bananeneis	SWEET
Bananenmilch	MILK
Bananenmilchshake	MILK
Bananenmus	FRUIT
Bananennektar	BEVERAGE
Bananenpfannkuchen	SWEET
Bananensaft	BEVERAGE
Bandnudel	STARCH
Barbe	MEAT
Bärentraube	FRUIT
Bärlauch	SPICE
Bärlauchsoße	SPICE
Barsch	MEAT
Basilikum	SPICE
Basilikumblatt	SPICE
Basmatireis	STARCH
Batavia	VEGE
Bauchspeck	MEAT
Bauernbrot	STARCH
Bauernsalat	VEGE
Bechamelsoße	SPICE
Beef	MEAT
Beefsteak	MEAT
Beere	FRUIT
Beerenobst	FRUIT
Beifuß	SPICE
Beilage	STARCH
Bergkäse	MILK
Berliner	SWEET
Betthupferl	SWEET
Bickbeere	FRUIT
Bier	BEVERAGE
Bierhefe	GRAIN
Bierschinken	MEAT
Biobrot	STARCH
Bioei	EGG
Biofleisch	MEAT
Biogemüse	VEGE
Biomehl	GRAIN
Biomilch	MILK
Bioobst	FRUIT
Biosaft	BEVERAGE
Biosalat	VEGE
Biozitrone	FRUIT
Birkenblättertee	BEVERAGE
Birkenpilz	VEGE
Birne	FRUIT
Birnenkompott	FRUIT
Birnennektar	BEVERAGE
Birnensaft	BEVERAGE
Birnenschnaps	BEVERAGE
Birnenwasser	BEVERAGE
Biskuitboden	SWEET
Biskuit-Rolle	SWEET
Bismarckhering	MEAT
Bisonsteak	MEAT
Bitterbier	BEVERAGE
Bittermandelaroma	SPICE
Blasentee	BEVERAGE
Blätterteiggebäck	SWEET
Blätterteigtasche	SWEET
Blätterteigteilchen	SWEET
Blattgemüse	VEGE
Blattkohl	VEGE
Blattsalat	VEGE
Blaubeere	FRUIT
Blaukraut	VEGE
Blauschimmelkäse	MILK
Bleichsellerie	VEGE
Blini	SWEET
Blockschokolade	SWEET
Blümchenkaffee	BEVERAGE
Blumenkohl	VEGE
Blumenkohl-Brokkoli-Suppe	VEGE
Blumenkohlgratin	VEGE
Blumenkohlsuppe	VEGE
Blutwurst	MEAT
Bock	MEAT
Bockbier	BEVERAGE
Bockshornkleesamen	GRAIN
Bockwurst	MEAT
Bohne	VEGE
Bohnen-Champignon-Gemüse	VEGE
Bohneneintopf	VEGE
Bohnengericht	VEGE
Bohnenkaffee	BEVERAGE
Bohnenkraut	SPICE
Bohnensalat	VEGE
Bohnensuppe	VEGE
Bolognesesoße	SPICE
Bonbon	SWEET
Bordeaux	BEVERAGE
Borretsch	SPICE
Borschtsch	VEGE
Bouillabaisse	MEAT
Bovist	VEGE
Brandy	BEVERAGE
Branntwein	BEVERAGE
Branntweinessig	SPICE
Bratapfel	SWEET
Braten	MEAT
Bratenaufschnitt	MEAT
Bratensoße	SPICE
Bratfett	FAT
Brathähnchen	MEAT
Brathuhn	MEAT
Brathühnchen	MEAT
Bratkartoffel	STARCH
Bratnudel	STARCH
Bratwurst	MEAT
Bratwurstmasse	MEAT
Braugerste	GRAIN
Brause	BEVERAGE
Brausepulver	SWEET
Brei	STARCH
Brennesselsaft	BEVERAGE
Brennnesseltee	BEVERAGE
Brezel	STARCH
Brie	MILK
Bries	MEAT
Brioche	SWEET
Brokkoli	VEGE
Brokkoli-Auflauf	VEGE
Brokkolicremesuppe	VEGE
Brokkoli-Pizza	STARCH
Brokkoli-Quiche	STARCH
Brokkolisuppe	VEGE
Brombeere	FRUIT
Brombeersaft	BEVERAGE
Brot	STARCH
Brötchen	STARCH
Brötchensonne	STARCH
Brotgetreide	GRAIN
Brotsoße	SPICE
Brotspeise	STARCH
Brottrunk	BEVERAGE
Brotweizen	GRAIN
Brownie	SWEET
Brühwurst	MEAT
Brunnenkresse	VEGE
Bucatini	STARCH
Buchtel	SWEET
Buchweizen	GRAIN
Buchweizenflocken	GRAIN
Buchweizengrütze	STARCH
Buchweizenmehl	GRAIN
Bulette	MEAT
Bulgur	STARCH
Bulgursalat	STARCH
Burger	MEAT
Burgunder	BEVERAGE
Burgunderwein	BEVERAGE
Burrito	MEAT
Butter	FAT
Butterbrot	STARCH
Buttercremetorte	SWEET
Butterfisch	MEAT
Butterkäse	MILK
Butterkeks	SWEET
Butterkuchen	SWEET
Buttermilch	MILK
Butterpilz	VEGE
Butterschmalz	FAT
Buttersoße	SPICE
Cabanossi	MEAT
Caipirinha	BEVERAGE
Calvados	BEVERAGE
Camembert	MILK
Campari	BEVERAGE
Campari-Orange	BEVERAGE
Campari-Soda	BEVERAGE
Cannelloni	STARCH
Cappuccino	BEVERAGE
Caramelbonbon	SWEET
Carbonarasoße	SPICE
Caro-Kaffee	BEVERAGE
Carpaccio	MEAT
Cashewkern	GRAIN
Cashewnuss	GRAIN
Cayennepfeffer	SPICE
Cervelat	MEAT
Cevapcici	MEAT
Ceviche	MEAT
Chablis	BEVERAGE
Champagner	BEVERAGE
Champignon	VEGE
Champignon-Cremesuppe	VEGE
Champignon-Omelett	EGG
Champignonpfanne	VEGE
Champignonragout	VEGE
Champignon-Rahmsoße	SPICE
Champignon-Zucchini-Soße	SPICE
Chardonnay	BEVERAGE
Cheddar	MILK
Cheeseburger	MEAT
Cherrytomate	VEGE
Chester	MILK
Chianti	BEVERAGE
Chicoree	VEGE
Chicorée	VEGE
Chili	SPICE
Chilipaste	SPICE
Chilipulver	SPICE
Chilischote	SPICE
Chilisauce	SPICE
Chinakohl	VEGE
Chip	SWEET
Chorizo	MEAT
Chutney	SPICE
Cidre	BEVERAGE
Clementine	FRUIT
Coca-Cola	BEVERAGE
Cocktail	BEVERAGE
Cocktailwürstchen	MEAT
Cognac	BEVERAGE
Coke	BEVERAGE
Cola	BEVERAGE
Colostrum	MILK
Cornichon	VEGE
Cranberry	FRUIT
Cranberrysaft	BEVERAGE
Cremespeise	SWEET
Cremetorte	SWEET
Crepe	SWEET
Croissant	STARCH
Cumberlandsauce	SPICE
Curry	SPICE
Currypulver	SPICE
Currysauce	SPICE
Currywurst	MEAT
Daiquiri	BEVERAGE
Dampfbier	BEVERAGE
Dampfkartoffel	STARCH
Dattel	FRUIT
Datteltomate	VEGE
Dauergebäck	SWEET
Debrecziner	MEAT
Dessert	SWEET
Diätjoghurt	MILK
Diätpudding	SWEET
Dickmilch	MILK
Dicksaft	BEVERAGE
Digestif	BEVERAGE
Dill	SPICE
Dillsoße	SPICE
Dinkel	GRAIN
Dinkelflocken	GRAIN
Dinkelmehl	GRAIN
Dip	SPICE
Distelöl	FAT
Ditali	STARCH
Donauwelle	SWEET
Döner	MEAT
Donut	SWEET
Doppelrahmfrischkäse	MILK
Dorade	MEAT
Dörrfleisch	MEAT
Dorsch	MEAT
Dorschleber	MEAT
Dosenmilch	MILK
Dragon	SPICE
Dreifrucht	SWEET
Dreikornbrot	STARCH
Dressing	SPICE
Drink	BEVERAGE
Dunkelbier	BEVERAGE
Ebly	STARCH
Edamer	MILK
Edelkastanienhonig	SWEET
Edelschimmelkäse	MILK
Egerling	VEGE
Ei	EGG
Eibischwurzeltee	BEVERAGE
Eierbovist	VEGE
Eierfrikassee	EGG
Eierfrucht	VEGE
Eierkuchen	SWEET
Eierlikör	BEVERAGE
Eierlikörkuchen	SWEET
Eiernudel	STARCH
Eierpfannkuchen	SWEET
Eiersalat	EGG
Eiersoße	SPICE
Eierspeise	EGG
Eierstich	EGG
Eigelb	EGG
Eiklar	EGG
Einbrenne	STARCH
Eiprodukt	EGG
Eis	SWEET
Eisbecher	SWEET
Eisbein	MEAT
Eiscreme	SWEET
Eiskaffee	BEVERAGE
Eiskonfekt	SWEET
Eisoße	SPICE
Eissalat	VEGE
Eistee	BEVERAGE
Eistorte	SWEET
Elbling	BEVERAGE
Emmentaler	MILK
Endiviensalat	VEGE
Energydrink	BEVERAGE
Energy-Drink	BEVERAGE
Ente	MEAT
Entenbrust	MEAT
Entenschenkel	MEAT
Erbse	VEGE
Erbseneintopf	VEGE
Erbsengericht	VEGE
Erbsensuppe	VEGE
Erbswurst	VEGE
Erdbeerbowle	BEVERAGE
Erdbeere	FRUIT
Erdbeereis	SWEET
Erdbeerkompott	FRUIT
Erdbeermarmelade	SWEET
Erdbeersekt	BEVERAGE
Erdbeersirup	SPICE
Erdbeertorte	SWEET
Erdnusskern	GRAIN
Erdnussöl	FAT
Erdnusssoße	SPICE
Erfrischungsgetränk	BEVERAGE
Espresso	BEVERAGE
Essig	SPICE
Essiggemüse	VEGE
Essiggurke	VEGE
Essigwasser	SPICE
Estragon	SPICE
Export	BEVERAGE
Fadennudel	STARCH
Fajita	MEAT
Falafel	STARCH
Farfalle	STARCH
Fasan	MEAT
Feige	FRUIT
Feinbackware	SWEET
Felchen	MEAT
Feldsalat	VEGE
Feldthymian	SPICE
Fenchel	VEGE
Fenchelgemüse	VEGE
Fenchelhonig	SWEET
Fenchelsaat	SPICE
Fencheltee	BEVERAGE
Fertigdressing	SPICE
Fertigmilch	MILK
Fertigsoße	SPICE
Festbier	BEVERAGE
Feta	MILK
Fett	FAT
Fettgebäck	SWEET
Fettgebackenes	SWEET
Feuerzangenbowle	BEVERAGE
Filetsteak	MEAT
Fisch	MEAT
Fischbeuschel	MEAT
Fischfilet	MEAT
Fischfrikadelle	MEAT
Fischgericht	MEAT
Fischklößchen	MEAT
Fischkonserve	MEAT
Fischleber	MEAT
Fischplatte	MEAT
Fischsalat	MEAT
Fischstäbchen	MEAT
Fischsuppe	MEAT
Fladen	STARCH
Fladenbrot	STARCH
Flammkuchen	SWEET
Flan	SWEET
Flaschenbier	BEVERAGE
Flaschenbovist	VEGE
Flaschentomate	VEGE
Fleisch	MEAT
Fleischerzeugnis	MEAT
Fleischgericht	MEAT
Fleischkäse	MEAT
Fleischkonserve	MEAT
Fleischprodukt	MEAT
Fleischsalat	MEAT
Fleischspeise	MEAT
Fleischspieß	MEAT
Fleischsuppe	MEAT
Fleischtomate	VEGE
Fleischware	MEAT
Fleischwurst	MEAT
Fliederblütentee	BEVERAGE
Fliedertee	BEVERAGE
Florentiner	SWEET
Flügel	MEAT
Folienkartoffel	STARCH
Fonduekäse	MILK
Forelle	MEAT
Forellenfilet	MEAT
Frankfurter	MEAT
Franzbrötchen	SWEET
Frikadelle	MEAT
Frikadellenauflauf	MEAT
Frischfleisch	MEAT
Frischkäse	MILK
Frischkornbrei	STARCH
Frischkornmüsli	STARCH
Frischwasser	BEVERAGE
Froschschenkel	MEAT
Frucht	FRUIT
Fruchtaufstrich	SWEET
Fruchtbuttermilch	MILK
Früchtebrot	SWEET
Fruchteis	SWEET
Früchtetee	BEVERAGE
Fruchtfleisch	FRUIT
Fruchtgemüse	VEGE
Fruchtgrütze	SWEET
Fruchtjoghurt	MILK
Fruchtnektar	BEVERAGE
Fruchtquark	MILK
Fruchtsaft	BEVERAGE
Fruchtsaftkonzentrat	BEVERAGE
Fruchtschaumwein	BEVERAGE
Fruchtsorbet	SWEET
Fruchtwein	BEVERAGE
Frühlingszwiebel	SPICE
Frühstücksspeck	MEAT
Fürst-Pückler-Eis	SWEET
Fusel	BEVERAGE
Gabelspaghetti	STARCH
Gambaspieß	MEAT
Gans	MEAT
Gänsebraten	MEAT
Gänsekeule	MEAT
Gänsekresse	VEGE
Garnele	MEAT
Garnelenpaste	MEAT
Gartenkraut	SPICE
Gartenkresse	VEGE
Gartensalbei	SPICE
Gebäck	SWEET
Gebräu	BEVERAGE
Geflügel	MEAT
Geflügelaufschnitt	MEAT
Geflügelfilet	MEAT
Geflügelleber	MEAT
Geflügelsalat	MEAT
Geflügelstück	MEAT
Geflügelwürstchen	MEAT
Gemüse	VEGE
Gemüsebrei	VEGE
Gemüseeintopf	VEGE
Gemüsegericht	VEGE
Gemüsegratin	VEGE
Gemüsekonserve	VEGE
Gemüsekroketten	VEGE
Gemüsekuchen	SWEET
Gemüse-Lasagne	VEGE
Gemüsequiche	SWEET
Gemüseragout	VEGE
Gemüsesaft	BEVERAGE
Gemüsesalat	VEGE
Gemüsespieß	VEGE
Gemüsestick	VEGE
Gemüsesuppe	VEGE
Gemüsezwiebel	VEGE
Gepökeltes	MEAT
Gerste	GRAIN
Gerstenbrei	STARCH
Gerstenflocken	GRAIN
Gerstenmalz	GRAIN
Gerstensaft	BEVERAGE
Geschmacksverstärker	SPICE
Geschnetzeltes	MEAT
Gesöff	BEVERAGE
Getränk	BEVERAGE
Getreide	GRAIN
Getreidegericht	STARCH
Getreidekaffee	BEVERAGE
Getreidekeimling	GRAIN
Getreideprodukt	STARCH
Gewürz	SPICE
Gewürzgurke	VEGE
Gewürzmischung	SPICE
Gewürznelke	SPICE
Gewürzpaprika	SPICE
Gewürzpaste	SPICE
Gewürzpulver	SPICE
Gewürzsalz	SPICE
Gewürzsauce	SPICE
Gin	BEVERAGE
Ginger-Ale	BEVERAGE
Gin-Tonic	BEVERAGE
Glasnudel	STARCH
Glasnudelsuppe	STARCH
Glucosesirup	SPICE
Glühmost	BEVERAGE
Glühwein	BEVERAGE
Gnocchi	STARCH
Gnocchisalat	STARCH
Gojibeere	FRUIT
Goldbarsch	MEAT
Goldrutentee	BEVERAGE
Gorgonzola	MILK
Gorgonzolasoße	SPICE
Götterspeise	SWEET
Gouda	MILK
Grahambrot	STARCH
Graham-Cracker	SWEET
Granatapfel	FRUIT
Grapefrucht	FRUIT
Grapefruit	FRUIT
Grapefruitsaft	BEVERAGE
Grappa	BEVERAGE
Gratinkäse	MILK
Graubrot	STARCH
Grauburgunder	BEVERAGE
Graupe	GRAIN
Grieß	GRAIN
Grießbrei	STARCH
Grießklößchen	STARCH
Grießpudding	SWEET
Grießschmarren	SWEET
Grillfleisch	MEAT
Grilltomaten	VEGE
Grünkern	GRAIN
Grünkernbratling	VEGE
Grünkernschrot	GRAIN
Grünkohl	VEGE
Grütze	STARCH
Grützwurst	MEAT
Guava	FRUIT
Guave	FRUIT
Gugelhupf	SWEET
Guinness	BEVERAGE
Gulasch	MEAT
Gulaschsuppe	MEAT
Gulasch-Topf	MEAT
Gummibärchen	SWEET
Gurke	VEGE
Gurkenkraut	SPICE
Gurkensalat	VEGE
Hackbraten	MEAT
Hackfleisch	MEAT
Hackfleischbällchen	MEAT
Hackfleischblech	MEAT
Hackfleischbrötchen	MEAT
Hackfleisch-Lauch-Suppe	MEAT
Hackfleischnest	MEAT
Hackfleischpastete	MEAT
Hackfleischpfanne	MEAT
Hackfleisch-Pie	MEAT
Hackfleischragout	MEAT
Hackfleischsoße	MEAT
Hackfleischspieß	MEAT
Hackfleischsuppe	MEAT
Hackfleischtoast	MEAT
Hackfleischtorte	MEAT
Hackfleischzopf	MEAT
Hafer	GRAIN
Haferbrei	STARCH
Hafergrütze	STARCH
Haferkleie	GRAIN
Haferschleimsuppe	STARCH
Hagebutte	FRUIT
Hagebuttentee	BEVERAGE
Hähnchen	MEAT
Hähnchenbrust	MEAT
Hähnchenbrustfilet	MEAT
Hähnchen-Curry	MEAT
Hähnchenkeule	MEAT
Hähnchenleber	MEAT
Hähnchenschenkel	MEAT
Hähnchenschnitzel	MEAT
Halbfettmargarine	FAT
Halbhartkäse	MILK
Hallimasch	VEGE
Hamburger	MEAT
Hamburgersoße	SPICE
Hammel	MEAT
Hammelfleisch	MEAT
Hanfnuss	GRAIN
Hanföl	FAT
Hartkäse	MILK
Hartweizengrieß	GRAIN
Hase	MEAT
Haselnusskern	GRAIN
Haselnussöl	FAT
Hasenrückenfilet	MEAT
Haxe	MEAT
Hefegebäck	SWEET
Hefekranz	SWEET
Hefeteilchen	SWEET
Hefeweizen	GRAIN
Heidelbeere	FRUIT
Heilbutt	MEAT
Hering	MEAT
Heringsfilet	MEAT
Heringshappen	MEAT
Heringskartoffel	MEAT
Heringsröllchen	MEAT
Heringssalat	MEAT
Heringsstip	MEAT
Herrentorte	SWEET
Herz	MEAT
Herzmuschel	MEAT
Hibiscustee	BEVERAGE
Himbeer	FRUIT
Himbeere	FRUIT
Himbeereis	SWEET
Himbeeressig	SPICE
Himbeergeist	BEVERAGE
Himbeersaft	BEVERAGE
Himbeerschnaps	BEVERAGE
Himbeertorte	SWEET
Himbeerwasser	BEVERAGE
Hinterschinken	MEAT
Hirn	MEAT
Hirsch	MEAT
Hirschgulasch	MEAT
Hirschsalami	MEAT
Hirse	GRAIN
Hirsebrei	STARCH
Hirseflocken	GRAIN
Hirtensalat	VEGE
H-Milch	MILK
Höhlenkäse	MILK
Hokkaido	VEGE
Holunderbeere	FRUIT
Holunderblütentee	BEVERAGE
Holundersaft	BEVERAGE
Holunderwein	BEVERAGE
Honig	SWEET
Honigbonbon	SWEET
Honigkuchen	SWEET
Honigmelone	FRUIT
Hopfenzapfen	GRAIN
Hörnchen	STARCH
Hörnchennudel	STARCH
Hotdog	MEAT
Hotdog-Brötchen	STARCH
Hüftsteak	MEAT
Huhn	MEAT
Hühnchen	MEAT
Hühnerei	EGG
Hühnerfrikassee	MEAT
Hühnerleber	MEAT
Hühnersuppe	MEAT
Hülsenfrucht	VEGE
Hummer	MEAT
Hummersalat	MEAT
Hummersuppe	MEAT
Hüttenkäse	MILK
Ingwer	SPICE
Ingwerkuchen	SWEET
Ingwerpulver	SPICE
Ingwertee	BEVERAGE
Innerei	MEAT
Instantgetränk	BEVERAGE
Jagdwurst	MEAT
Jägerschnitzel	MEAT
Jakobsmuschel	MEAT
Jamaikapfeffer	SPICE
Jaromakohl	VEGE
Jodsalz	SPICE
Joghurt	MILK
Joghurtdip	SPICE
Joghurtsoße	SPICE
Joghurt-Torte	SWEET
Johannisbeere	FRUIT
Johannisbeersaft	BEVERAGE
Johannisbrot	FRUIT
Jungstierfilet	MEAT
Kabeljau	MEAT
Kabeljaufilet	MEAT
Kaffee	BEVERAGE
Kaffeeersatz	BEVERAGE
Kaffee-Ersatz	BEVERAGE
Kaffeelikör	BEVERAGE
Kaffeemilch	MILK
Kaffeesahne	MILK
Kaiserschmarren	SWEET
Kaiserschmarrn	SWEET
Kaiserschotensalat	VEGE
Kakao	BEVERAGE
Kalb	MEAT
Kalbfleisch	MEAT
Kalbsbraten	MEAT
Kalbsbrust	MEAT
Kalbsleber	MEAT
Kalbsmedaillon	MEAT
Kalbsrücken	MEAT
Kaltschale	SWEET
Kamillentee	BEVERAGE
Kamutflocken	GRAIN
Kaninchen	MEAT
Kaninchenkeule	MEAT
Kaper	SPICE
Kappes	VEGE
Kapuzinerkresseblüte	SPICE
Kardamom	SPICE
Karotte	VEGE
Karottensaft	BEVERAGE
Karpfen	MEAT
Kartoffel	STARCH
Kartoffelauflauf	STARCH
Kartoffelbällchen	STARCH
Kartoffelbrei	STARCH
Kartoffelbrot	STARCH
Kartoffelchip	SWEET
Kartoffelecke	STARCH
Kartoffelgericht	STARCH
Kartoffelgratin	STARCH
Kartoffelhörnchen	STARCH
Kartoffelkloß	STARCH
Kartoffelknödel	STARCH
Kartoffelpfanne	STARCH
Kartoffelpuffer	STARCH
Kartoffelpüree	STARCH
Kartoffelsalat	STARCH
Kartoffelschmarrn	STARCH
Kartoffelsuppe	STARCH
Käse	MILK
Käseaufschnitt	MILK
Käsegebäck	SWEET
Käsehäppchen	MILK
Käsekuchen	SWEET
Käse-Sahne-Torte	SWEET
Käsesoße	SPICE
Käsespätzle	STARCH
Käsewürfel	MILK
Kasselerkotelett	MEAT
Kassler	MEAT
Kässpätzle	STARCH
Katenschinken	MEAT
Katenspeck	MEAT
Kaviar	MEAT
Kebab	MEAT
Kefir	MILK
Keimöl	FAT
Keks	SWEET
Kerbel	SPICE
Kernobst	FRUIT
Ketchup	SPICE
Kichererbse	VEGE
Kidneybohne	VEGE
Kinderpunsch	BEVERAGE
Kipferl	SWEET
Kirsch	BEVERAGE
Kirsche	FRUIT
Kirschgeist	BEVERAGE
Kirschkuchen	SWEET
Kirschmarmelade	SWEET
Kirschnektar	BEVERAGE
Kirschsaft	BEVERAGE
Kirschschnaps	BEVERAGE
Kirschwasser	BEVERAGE
Kiwi	FRUIT
Kleiebrot	STARCH
Kleingebäck	SWEET
Klippfisch	MEAT
Klops	MEAT
Kloß	STARCH
Knabberei	SWEET
Knabbergebäck	SWEET
Knabberzeug	SWEET
Knäckebrot	STARCH
Knackwurst	MEAT
Knoblauch	SPICE
Knoblauch-Essig	SPICE
Knoblauchöl	SPICE
Knoblauchpaste	SPICE
Knoblauchpulver	SPICE
Knoblauchsoße	SPICE
Knödel	STARCH
Knollengemüse	VEGE
Knollensellerie	VEGE
Kochcreme	FAT
Kochschinken	MEAT
Kochwurst	MEAT
Kochwürstchen	MEAT
Kohl	VEGE
Kohlpfanne	VEGE
Kohlrabi	VEGE
Kohlrabisuppe	VEGE
Kohlsuppe	VEGE
Kokosfett	FAT
Kokosöl	FAT
Kolbenhirse	GRAIN
Kölsch	BEVERAGE
Kombucha	BEVERAGE
Kondensmilch	MILK
Konfekt	SWEET
Konfitüre	SWEET
Kopfsalat	VEGE
Koriander	SPICE
Koriandergrün	SPICE
Korn	GRAIN
Kotelett	MEAT
Krabbe	MEAT
Krabbencocktail	MEAT
Krabbenfleisch	MEAT
Krabbenpaste	MEAT
Krabbenrührei	MEAT
Krabbensalat	MEAT
Krabbensuppe	MEAT
Krachsalat	VEGE
Kräcker	SWEET
Krähenbeere	FRUIT
Krakauer	MEAT
Kranz	SWEET
Kranzkuchen	SWEET
Krapfen	SWEET
Kraut	VEGE
Kräuterbutter	FAT
Kräuteressig	SPICE
Kräuterlikör	BEVERAGE
Kräuterling	BEVERAGE
Kräuteröl	SPICE
Kräuterquark	MILK
Kräutersalz	SPICE
Kräuterschmelze	SPICE
Kräutersoße	SPICE
Kräutertee	BEVERAGE
Krautsalat	VEGE
Krebs	MEAT
Krebsbutter	FAT
Krebsfleisch	MEAT
Krebssuppe	MEAT
Kresse	VEGE
Kressesalat	VEGE
Kreuzkümmel	SPICE
Kristallweizen	GRAIN
Kritharaki	STARCH
Krokette	STARCH
Krustentier	MEAT
Kuchen	SWEET
Küchenkraut	SPICE
Kuhmilch	MILK
Kümmel	SPICE
Kümmel-Anis-Fenchel-Tee	BEVERAGE
Kümmelöl	FAT
Kümmeltee	BEVERAGE
Kunsthonig	SWEET
Kürbis	VEGE
Kürbisfrucht	FRUIT
Kürbiskern	GRAIN
Kurkuma	SPICE
Kuvertüre	SWEET
Lachs	MEAT
Lachscreme	MEAT
Lachsfilet	MEAT
Lachsforelle	MEAT
Lachsröllchen	MEAT
Lachsschnittchen	MEAT
Lakritz	SWEET
Lakritzschnecke	SWEET
Lamm	MEAT
Lammfilet	MEAT
Lammfleisch	MEAT
Lammkeule	MEAT
Lammsalami	MEAT
Lammwurst	MEAT
Langkornreis	STARCH
Languste	MEAT
Langustine	MEAT
Lasagne	STARCH
Lasagneplatte	STARCH
Lauch	VEGE
Laugenbrötchen	STARCH
Laugengebäck	SWEET
Laugenstange	STARCH
Leber	MEAT
Leberknödel	MEAT
Leberpastete	MEAT
Lebkuchen	SWEET
Leerdamer	MILK
Leindotteröl	FAT
Leinöl	FAT
Leinsamenbrot	STARCH
Leitungswasser	BEVERAGE
Lengfisch	MEAT
Liebstöckel	SPICE
Likör	BEVERAGE
Limabohne	VEGE
Limburger	MILK
Limette	FRUIT
Limettensaft	BEVERAGE
Limo	BEVERAGE
Limonade	BEVERAGE
Limone	FRUIT
Lindenblütentee	BEVERAGE
Linse	VEGE
Linseneintopf	VEGE
Linsengericht	VEGE
Linsensalat	VEGE
Linsensuppe	VEGE
Litschi	FRUIT
Löffelbiskuit	SWEET
Löffelkraut	VEGE
Longdrink	BEVERAGE
Lorbeer	SPICE
Löwenzahnsalat	VEGE
Löwenzahntee	BEVERAGE
Lunge	MEAT
Lungenwurst	MEAT
Lutschbonbon	SWEET
Lutscher	SWEET
Lyoner	MEAT
Macadamia	GRAIN
Maccaroni	STARCH
Macis	SPICE
Magenbitter	BEVERAGE
Magermilch	MILK
Magermilchjoghurt	MILK
Magerquark	MILK
Maggi	SPICE
Maibock	BEVERAGE
Mais	VEGE
Maiskeimöl	FAT
Maiskölbchen	VEGE
Maiskolben	VEGE
Majoran	SPICE
Makkaroni	STARCH
Makrele	MEAT
Malventee	BEVERAGE
Malz	GRAIN
Malzbier	BEVERAGE
Mandel	GRAIN
Mandelblättchen	GRAIN
Mandelkern	GRAIN
Mandellikör	BEVERAGE
Mandelpudding	SWEET
Mandelstift	GRAIN
Mango	FRUIT
Mangold	VEGE
Mangonektar	BEVERAGE
Mangopflaume	FRUIT
Mangosaft	SWEET
Maniok	VEGE
Maracuja	FRUIT
Maräne	MEAT
Margarine	FAT
Mariendisteltee	BEVERAGE
Marille	FRUIT
Marillengeist	BEVERAGE
Marillenschnaps	BEVERAGE
Marinade	SPICE
Markklößchensuppe	STARCH
Marmelade	SWEET
Marmorkuchen	SWEET
Maronenpilz	VEGE
Martini	BEVERAGE
Märzen	BEVERAGE
Marzipan	SWEET
Marzipanartikel	SWEET
Marzipanfigur	SWEET
Marzipanrohmasse	SWEET
Marzipantorte	SWEET
Mascarpone	SWEET
Mastente	MEAT
Mastgans	MEAT
Matetee	MEAT
Matjes	MEAT
Mayonnaise	SPICE
Meeresfrucht	MEAT
Meerettichsahne	SPICE
Meerrettich	VEGE
Meerrettichsoße	SPICE
Meersalz	SPICE
Mehl	GRAIN
Mehlspeise	SWEET
Mehrkornbrötchen	STARCH
Melange	BEVERAGE
Melone	FRUIT
Menschenfleisch	MEAT
Merguez	MEAT
Merlot	BEVERAGE
Met	BEVERAGE
Mett	MEAT
Mettbrötchen	MEAT
Mettwurst	MEAT
Mettwürstchen	MEAT
Mezzo-Mix	BEVERAGE
Miesmuschel	MEAT
Miesmuscheltopf	MEAT
Milch	MILK
Milchbrei	SWEET
Milchbrot	STARCH
Milcheis	SWEET
Milchkaffee	BEVERAGE
Milchmixgetränk	MILK
Milchprodukt	MILK
Milchpudding	SWEET
Milchpulver	MILK
Milchreis	SWEET
Milchschokolade	SWEET
Milchshake	MILK
Milchsuppe	MILK
Milz	MEAT
Mineralwasser	BEVERAGE
Minze	SPICE
Mirabelle	FRUIT
Mirabellenschnaps	BEVERAGE
Mirabellenwasser	BEVERAGE
Mischbrot	STARCH
Mohn	SPICE
Mohnbrötchen	STARCH
Mohnkuchen	SWEET
Mohnsamen	SPICE
Möhre	VEGE
Möhrenkuchen	SWEET
Möhrensaft	BEVERAGE
Möhrensalat	VEGE
Möhrensuppe	VEGE
Mohrrübe	VEGE
Mokka	BEVERAGE
Molke	MILK
Molkekonzentrat	MILK
Mönchskopf	VEGE
Mortadella	MEAT
Most	BEVERAGE
Mostrich	SPICE
Mozartkugel	SWEET
Mozzarella	MILK
Muckefuck	BEVERAGE
Muffin	SWEET
Müller-Thurgau	BEVERAGE
Multivitaminsaft	BEVERAGE
Mungobohne	VEGE
Mungobohnensprosse	VEGE
Mürbegebäck	SWEET
Muschel	MEAT
Muschel-Cocktail	MEAT
Muschelnudel	STARCH
Muschelsuppe	MEAT
Muskat	SPICE
Muskelfleisch	MEAT
Nacho	SWEET
Nachspeise	SWEET
Nachtisch	SWEET
Nackthafer	GRAIN
Naturjoghurt	MILK
Naturreis	STARCH
Nektar	BEVERAGE
Nektarine	FRUIT
Nelke	SPICE
Netzmelone	FRUIT
Niere	MEAT
Nierentee	BEVERAGE
Nougat	SWEET
Nudel	STARCH
Nudelauflauf	STARCH
Nudelgericht	STARCH
Nudelsalat	STARCH
Nudelsuppe	STARCH
Nudelteig	STARCH
Nudeltorte	STARCH
Nugat	SWEET
Nussbrot	STARCH
Nussecke	SWEET
Nusskern	GRAIN
Nussöl	FAT
Nutella	SWEET
Nutellabrot	SWEET
Oblate	SWEET
Obst	FRUIT
Obstessig	SPICE
Obstkonserve	FRUIT
Obstkuchen	SWEET
Obstler	BEVERAGE
Obstsaft	BEVERAGE
Obstsalat	FRUIT
Obstschnaps	BEVERAGE
Obstspeise	FRUIT
Obsttorte	SWEET
Obstwasser	BEVERAGE
Ochse	MEAT
Ochsenfleisch	MEAT
Ochsenschwanzsuppe	MEAT
Ofenkartoffel	STARCH
Ökobrot	STARCH
Ökofleisch	MEAT
Ökogemüse	VEGE
Ökomilch	MILK
Okraschote	VEGE
Öl	FAT
Olive	VEGE
Olivenöl	FAT
Ölsardine	MEAT
Omega-3-Fettsäure	FAT
Omelett	EGG
Orange	FRUIT
Orangenlikör	BEVERAGE
Orangenlimonade	BEVERAGE
Orangenmarmelade	SWEET
Orangensaft	BEVERAGE
Orangenschalenaroma	SPICE
Orangenschalentee	BEVERAGE
Orecchiette	STARCH
Oregano	SPICE
Osterei	EGG
Paellareis	STARCH
Palmfett	FAT
Palmöl	FAT
Palmzucker	SPICE
Pampelmuse	FRUIT
Pampelmusensaft	BEVERAGE
Pangasiusfilet	MEAT
Papaya	FRUIT
Paprika	VEGE
Paprikachip	SWEET
Paprika-Hähnchen	MEAT
Paprika-Omelett	EGG
Paprikapulver	SPICE
Paprika-Rahmschnitzel	MEAT
Paprika-Reissalat	STARCH
Paprika-Rührei	EGG
Paprikasalami	MEAT
Paprikasalat	VEGE
Paprika-Salat	VEGE
Paprikaschote	VEGE
Paprikasoße	SPICE
Paprika-Tomaten-Soße	SPICE
Paranuss	GRAIN
Parasolpilz	VEGE
Parmaschinken	MEAT
Parmesan	MILK
Passionsfrucht	FRUIT
Pasta	STARCH
Pastete	MEAT
Pastinake	VEGE
Pastis	BEVERAGE
Patnareis	STARCH
Pecorino	MILK
Pekannuss	GRAIN
Pellkartoffel	STARCH
Pelmeni	MEAT
Penne	STARCH
Peperoni	VEGE
Peperonisalami	MEAT
Pepsi	BEVERAGE
Pepsi-Cola	BEVERAGE
Perlhuhn	MEAT
Pernod	BEVERAGE
Pesto	SPICE
Petersilie	SPICE
Petersiliensaft	SPICE
Petersiliensoße	SPICE
Petersilientee	BEVERAGE
Pfannengyros	MEAT
Pfannkuchen	SWEET
Pfeffer	SPICE
Pfeffergurke	VEGE
Pfefferkorn	SPICE
Pfefferminze	SPICE
Pfefferminzöl	SPICE
Pfefferminztee	BEVERAGE
Pferdefilet	MEAT
Pfifferling	VEGE
Pfirsich	FRUIT
Pfirsichnektar	BEVERAGE
Pfirsichsaft	BEVERAGE
Pflanzenfett	FAT
Pflanzenöl	FAT
Pflaume	FRUIT
Pflaumenkompott	FRUIT
Pflaumenkuchen	SWEET
Pflaumenmus	FRUIT
Pflaumensaft	BEVERAGE
Pflaumenschnaps	BEVERAGE
Pflaumenwasser	BEVERAGE
Pils	BEVERAGE
Pilsener	BEVERAGE
Pilz	VEGE
Pilzragout	VEGE
Pilzsoße	SPICE
Piment	SPICE
Pimentkorn	SPICE
Pimpinelle	SPICE
Pinienkern	GRAIN
Pistazie	GRAIN
Pistazienkern	GRAIN
Pistazienreis	STARCH
Pitabrot	STARCH
Pizza	STARCH
Pizzabrötchen	STARCH
Pizzagewürz	SPICE
Plätzchen	SWEET
Plunder	SWEET
Plundergebäck	SWEET
Pökelfleisch	MEAT
Pökelsalz	SPICE
Pomeranze	FRUIT
Pommes	STARCH
Popcorn	SWEET
Porree	VEGE
Porridge	STARCH
Portwein	BEVERAGE
Prädikatswein	BEVERAGE
Praline	SWEET
Preiselbeere	FRUIT
Premiumwein	BEVERAGE
Printe	SWEET
Prinzessbohne	VEGE
Prosecco	BEVERAGE
Pudding	SWEET
Puderzucker	SPICE
Puffbohne	VEGE
Puffreis	STARCH
Pulverkaffee	BEVERAGE
Pumpernickel	STARCH
Pute	MEAT
Putenbrust	MEAT
Putenfleisch	MEAT
Putengeschnetzeltes	MEAT
Putenkeule	MEAT
Putenschinken	MEAT
Putenschnitzel	MEAT
Qualitätswein	BEVERAGE
Quark	MILK
Quarkcreme	SWEET
Quarkknödel	SWEET
Queckentee	BEVERAGE
Quinoaflocken	GRAIN
Quitte	FRUIT
Raclettekäse	MILK
Radi	VEGE
Radicchio	VEGE
Radieschen	VEGE
Radler	BEVERAGE
Rahm	MILK
Rahmsoße	SPICE
Ramazotti	BEVERAGE
Rapsöl	FAT
Rapunzel	VEGE
Ratatouille	VEGE
Rauchbier	BEVERAGE
Räucheraal	MEAT
Räucherfisch	MEAT
Räucherlachs	MEAT
Räucherspeck	MEAT
Rauchspeck	MEAT
Rauchwurst	MEAT
Rebensaft	BEVERAGE
Reh	MEAT
Rehrücken	MEAT
Reibekuchen	STARCH
Reis	STARCH
Reisbrei	STARCH
Reisgericht	STARCH
Reispfanne	STARCH
Reissalat	STARCH
Reissuppe	STARCH
Remoulade	SPICE
Remouladensoße	SPICE
Renke	MEAT
Rettich	VEGE
Rhabarber	FRUIT
Rhabarberkuchen	SWEET
Ricotta	MILK
Riesengarnele	MEAT
Riesling	BEVERAGE
Rieslingsekt	BEVERAGE
Rind	MEAT
Rinderbraten	MEAT
Rinderbrust	MEAT
Rinderfilet	MEAT
Rindergeschnetzeltes	MEAT
Rindergulasch	MEAT
Rinderhack	MEAT
Rinderleber	MEAT
Rinderzunge	MEAT
Rindfleisch	MEAT
Rindfleischsuppe	MEAT
Rindsleber	MEAT
Ringelblumentee	BEVERAGE
Rippchen	MEAT
Rippe	FAT
Risotto	STARCH
Risotto-Reis	STARCH
Roastbeef	MEAT
Rogen	MEAT
Roggen	GRAIN
Roggenbrot	STARCH
Roggenbrötchen	STARCH
Roggenflocken	GRAIN
Roggenmehl	GRAIN
Roggenprodukt	STARCH
Roggentoastie	STARCH
Rohkaffee	BEVERAGE
Rohkost	VEGE
Rohkostsalat	VEGE
Rohmilchprodukt	MILK
Röhrennudel	STARCH
Rohrzucker	SPICE
Rohschinken	MEAT
Rohwurst	MEAT
Rollbraten	MEAT
Romadur	MILK
Romanasalatherz	VEGE
Römersalat	VEGE
Roquefort	MILK
Rosenkohl	VEGE
Rosenpaprika	SPICE
Roséwein	BEVERAGE
Rosine	FRUIT
Rosinenbrot	STARCH
Rosinenstuten	STARCH
Rosmarin	SPICE
Rosmarinkartoffel	STARCH
Rostbraten	MEAT
Rostbratwurst	MEAT
Röstbrot	STARCH
Rostgemüse	VEGE
Rösti	STARCH
Röstzwiebel	SPICE
Rotbarbe	MEAT
Rotbarsch	MEAT
Rote-Bete-Saft	BEVERAGE
Rotkohl	VEGE
Rotkohlsalat	VEGE
Rotwein	BEVERAGE
Rotweinessig	SPICE
Rotweinsoße	SPICE
Roulade	MEAT
Rübe	VEGE
Rucola	VEGE
Rührei	EGG
Ruländer	BEVERAGE
Rum	BEVERAGE
Rumaroma	SPICE
Rum-Cola	BEVERAGE
Rumpsteak	MEAT
Rundkornreis	STARCH
Sachertorte	SWEET
Safran	SPICE
Safransoße	SPICE
Saft	BEVERAGE
Sahne	MILK
Sahneeis	SWEET
Sahnejoghurt	MILK
Sahnekäse	MILK
Sahnemeerrettich	SPICE
Sahnepudding	SWEET
Sahnequark	MILK
Sahneschnitzel	MEAT
Sahnesoße	SPICE
Sahnetoffee	SWEET
Sahnetorte	SWEET
Saisongemüse	VEGE
Salami	MEAT
Salat	VEGE
Salatcreme	SPICE
Salatsoße	SPICE
Salattasche	VEGE
Salbei	SPICE
Salbeibutter	FAT
Salbeitee	BEVERAGE
Salsa	SPICE
Salz	SPICE
Salzbutter	FAT
Salzgebäck	SWEET
Salzhering	MEAT
Salzkartoffel	STARCH
Salzstange	SWEET
Salzwasser	BEVERAGE
Sanddorn	FRUIT
Sanddornsaft	BEVERAGE
Sanddornsirup	SPICE
Sandkuchen	SWEET
Sandwichtoast	STARCH
Sandwich-Toast	STARCH
Sangrita	BEVERAGE
Sardelle	MEAT
Sardine	MEAT
Saubohne	VEGE
Sauerampfer	VEGE
Sauerbraten	MEAT
Sauerkirsche	FRUIT
Sauerkirschtorte	SWEET
Sauerkonserve	VEGE
Sauerkraut	VEGE
Sauerkrautsaft	BEVERAGE
Sauermilch	MILK
Sauermilchkäse	MILK
Sauermilchprodukt	MILK
Sauerrahm	MILK
Sauerteigbrot	STARCH
Säuglingsmilch	MILK
Saumagen	MEAT
Scampi	MEAT
Schachtelhalmtee	BEVERAGE
Schafgarbentee	BEVERAGE
Schafskäse	MILK
Schafsmilch	MILK
Schalentier	MEAT
Schalotte	SPICE
Schampus	BEVERAGE
Schaschlik	MEAT
Schaumwein	BEVERAGE
Schellfisch	MEAT
Schichtkäse	MILK
Schildkrötensuppe	MEAT
Schillerlocke	MEAT
Schimmelkäse	MILK
Schinken	MEAT
Schinkenspeck	MEAT
Schinkenwürfel	MEAT
Schlachtfleisch	MEAT
Schlagsahne	MILK
Schlangengurke	VEGE
Schleimzucker	SPICE
Schlemmerfilet	MEAT
Schmalz	FAT
Schmalzgebäck	SWEET
Schmand	MILK
Schmant	MILK
Schmelzkäse	MILK
Schmorbraten	MEAT
Schmorsauerkraut	VEGE
Schnaps	BEVERAGE
Schnittkäse	MILK
Schnittlauch	SPICE
Schnitzel	MEAT
Schokocreme	SWEET
Schokolade	SWEET
Schokoladeneis	SWEET
Schokoladenfondue	SWEET
Schokoladenglasur	SWEET
Schokoladenkuchen	SWEET
Schokoladenmousse	SWEET
Schokoladenplättchen	SWEET
Schokoladenraspel	SWEET
Schokoladenriegel	SWEET
Schokoladensoße	SPICE
Schokoladenstreusel	SWEET
Schokoladentorte	SWEET
Schokoplättchen	SWEET
Schokoriegel	SWEET
Schokotröpfchen	SWEET
Scholle	MEAT
Schollenfilet	MEAT
Schrotbrei	STARCH
Schupfnudel	STARCH
Schwarzbrot	STARCH
Schwarzriesling	BEVERAGE
Schwarztee	BEVERAGE
Schwarzwurzel	VEGE
Schwedenbitter	BEVERAGE
Schwedenmilch	MILK
Schwein	MEAT
Schweinebauch	MEAT
Schweinebraten	MEAT
Schweinefilet	MEAT
Schweinefleisch	MEAT
Schweinegeschnetzeltes	MEAT
Schweinegulasch	MEAT
Schweineleber	MEAT
Schweinemedaillon	MEAT
Schweinemett	MEAT
Schweinenacken	MEAT
Schweinenuss	MEAT
Schweineschmalz	FAT
Schweineschnitzel	MEAT
Schwenkbraten	MEAT
Scotch	BEVERAGE
Seefisch	MEAT
Seehecht	MEAT
Seelachsfilet	MEAT
Seetang	VEGE
Seeteufel	MEAT
Seezunge	MEAT
Sekt	BEVERAGE
Sellerie	VEGE
Sellerieknolle	VEGE
Selleriekraut	VEGE
Selleriesalat	VEGE
Selleriestange	VEGE
Selters	BEVERAGE
Semmel	STARCH
Semmelkloß	STARCH
Semmelknödel	STARCH
Semmelpilz	VEGE
Senf	SPICE
Senfbraten	MEAT
Senfkohl	VEGE
Senfkorn	SPICE
Senfpulver	SPICE
Senfsoße	SPICE
Serranoschinken	MEAT
Sesam	SPICE
Sesambrötchen	STARCH
Sesamöl	FAT
Sesamsoße	SPICE
Sherry	BEVERAGE
Shitake	VEGE
Shrimp	MEAT
Silberzwiebel	SPICE
Silvaner	BEVERAGE
Sirup	SPICE
Slibowitz	BEVERAGE
Soda	BEVERAGE
Sodawasser	BEVERAGE
Softdrink	BEVERAGE
Softeis	SWEET
Soja	VEGE
Sojabohne	VEGE
Sojabohnensprosse	VEGE
Sojadrink	BEVERAGE
Sojagranulat	GRAIN
Sojamehl	GRAIN
Sojaöl	FAT
Sojasoße	SPICE
Solei	EGG
Sonnenblumenkern	GRAIN
Sonnenblumenöl	FAT
Sonntagsbrötchen	STARCH
Sorbit	SPICE
Soße	SPICE
Spaghetti	STARCH
Spaghettisoße	SPICE
Sparerib	MEAT
Spargel	VEGE
Spargelcremesuppe	VEGE
Spargelsalat	VEGE
Spätburgunder	BEVERAGE
Spätlese	BEVERAGE
Spätzle	STARCH
Speck	MEAT
Speckschwarte	MEAT
Speiseeis	SWEET
Speisemorchel	VEGE
Speiseöl	FAT
Speisepilz	VEGE
Spezi	BEVERAGE
Spiegelei	EGG
Spießbraten	MEAT
Spinat	VEGE
Spinatsuppe	VEGE
Spiralnudel	STARCH
Spirituose	BEVERAGE
Spitzkohl	VEGE
Spitzwegerichsaft	BEVERAGE
Spitzwegerichtee	BEVERAGE
Spritzgebäck	SWEET
Sprosse	VEGE
Sprossensalat	VEGE
Sprudel	BEVERAGE
Sprühsahne	MILK
Stäbchenkartoffeln	STARCH
Stachelbeere	FRUIT
Stachelbeertorte	SWEET
Stangenbohne	VEGE
Staudensellerie	VEGE
Steak	MEAT
Steckrübe	VEGE
Steckrübenmus	VEGE
Steinbutt	MEAT
Steinobst	FRUIT
Steinpilz	VEGE
Steinpilzcremesuppe	VEGE
Sternanis	SPICE
Stevia	SPICE
Stielmus	VEGE
Stockfisch	MEAT
Stockschwämmchen	VEGE
Stollen	SWEET
Stout	BEVERAGE
Strauchtomate	VEGE
Streichfett	FAT
Streichkäse	MILK
Streichwurst	MEAT
Streuselkuchen	SWEET
Streusüße	SPICE
Striezel	SWEET
Strudel	SWEET
Stutenmilch	MILK
Südfrucht	FRUIT
Suppengrün	SPICE
Suppennudel	STARCH
Suppenwürfel	SPICE
Sushi	MEAT
Süßholzwurzel	SPICE
Süßigkeit	SWEET
Süßkartoffel	STARCH
Süßkirsche	FRUIT
Süßspeise	SWEET
Süßstoff	SPICE
Süßungsmittel	SPICE
Süßware	SWEET
Tabasco	SPICE
Tabascosoße	SPICE
Taco	SWEET
Tafelwasser	BEVERAGE
Tagliatelle	STARCH
Tartelette	SWEET
Tatar	MEAT
Tee	BEVERAGE
Teegebäck	SWEET
Teewurst	MEAT
Teigware	STARCH
Tequila	BEVERAGE
Teriyaki-Soße	SPICE
Thunfisch	MEAT
Thymian	SPICE
Thymiantee	BEVERAGE
Tiefkühlgemüse	VEGE
Tiefkühlpizza	STARCH
Tiefseegarnele	MEAT
Tilapia	MEAT
Tilsiter	MILK
Tintenfisch	MEAT
Tintenfischring	MEAT
Toast	STARCH
Toastbrot	STARCH
Tomate	VEGE
Tomaten-Brokkoli-Salat	VEGE
Tomatenmark	SPICE
Tomatenpüree	VEGE
Tomatensaft	BEVERAGE
Tomatensalat	VEGE
Tomatensoße	SPICE
Tonic-Water	BEVERAGE
Topinambur	VEGE
Torte	SWEET
Tortellini	STARCH
Tortellinisalat	STARCH
Tortencreme	SWEET
Tortilla	STARCH
Trank	BEVERAGE
Traube	FRUIT
Traubenmost	BEVERAGE
Traubenobst	FRUIT
Traubensaft	BEVERAGE
Tresterbranntwein	BEVERAGE
Trinkjoghurt	MILK
Trinkmilch	MILK
Trinkwasser	BEVERAGE
Trockenmilch	MILK
Trockenobst	FRUIT
Trollinger	BEVERAGE
Trüffel	VEGE
Trunk	BEVERAGE
Truthahn	MEAT
Unagi	MEAT
Vanille	SPICE
Vanillearoma	SPICE
Vanilleeis	SWEET
Vanillemark	SPICE
Vanillepudding	SWEET
Vanillepulver	SPICE
Vanilleschote	SPICE
Vanillesoße	SPICE
Vanillinzucker	SPICE
Venusmuschel	MEAT
Viktoriabarsch	MEAT
Vogelbeere	FRUIT
Vollkornbrot	STARCH
Vollkorngebäck	SWEET
Vollkorngetreide	GRAIN
Vollkornhaferflocken	GRAIN
Vollkornkeks	SWEET
Vollkornkuchen	SWEET
Vollkornmehl	GRAIN
Vollkornnudel	STARCH
Vollkornprodukt	STARCH
Vollkornreis	STARCH
Vollkornteigware	STARCH
Vollkorntoast	STARCH
Vollkornweizen	GRAIN
Vollmilch	MILK
Vorzugsmilch	MILK
Wacholderbeere	SPICE
Wacholderbranntwein	BEVERAGE
Wachtel	MEAT
Wachtelei	EGG
Wackelpeter	SWEET
Wackelpudding	SWEET
Waffel	SWEET
Waldchampignon	VEGE
Waldorfsalat	VEGE
Walnusskern	GRAIN
Walnussöl	FAT
Wasabi	SPICE
Wasser	BEVERAGE
Wassereis	SWEET
Wasserkakao	BEVERAGE
Wasserkastanie	VEGE
Wassermelone	FRUIT
Wecken	STARCH
Weckmännchen	SWEET
Weichkäse	MILK
Weichweizengrieß	GRAIN
Weihnachtsbier	BEVERAGE
Weihnachtsgebäck	SWEET
Wein	BEVERAGE
Weinbergschnecke	MEAT
Weinbrand	BEVERAGE
Weingummi	SWEET
Weinschorle	BEVERAGE
Weintraube	FRUIT
Weintraubenkern	GRAIN
Weißbier	BEVERAGE
Weißbrot	STARCH
Weißburgunder	BEVERAGE
Weiße	BEVERAGE
Weißkohl	VEGE
Weißkohlsalat	VEGE
Weißkraut	VEGE
Weißmehl	GRAIN
Weißwein	BEVERAGE
Weißweinessig	SPICE
Weißweinsoße	SPICE
Weißwurst	MEAT
Weizen	GRAIN
Weizenbier	BEVERAGE
Weizenbrot	STARCH
Weizenflocken	GRAIN
Weizengrieß	GRAIN
Weizenkeim	GRAIN
Weizenkeimöl	FAT
Weizenmehl	GRAIN
Weizenschrot	GRAIN
Wermut	BEVERAGE
Wermuttee	BEVERAGE
Whiskey	BEVERAGE
Whisky	BEVERAGE
Whisky-Cola	BEVERAGE
Whisky-Sahne-Likör	BEVERAGE
Wiener	MEAT
Wiesenkerbel	SPICE
Wiesensalbei	SPICE
Wild	MEAT
Wildbraten	MEAT
Wildbret	MEAT
Wildfleisch	MEAT
Wildlachs	MEAT
Wildpastete	MEAT
Wildreis	STARCH
Wildschwein	MEAT
Wildschweinschulter	MEAT
Wildschweinsteak	MEAT
Windbeutel	SWEET
Winterrettich	VEGE
Wirsing	VEGE
Wirsingkohl	VEGE
Wodka	BEVERAGE
Wodka-Orange	BEVERAGE
Wodka-Redbull	BEVERAGE
Wokgemüse	VEGE
Worcestersoße	SPICE
Wurst	MEAT
Würstchen	MEAT
Wurstgulasch	MEAT
Wurstsalat	MEAT
Würze	SPICE
Wurzelgemüse	VEGE
Würzsoße	SPICE
Zander	MEAT
Zanderfilet	MEAT
Zartbitterschokolade	SWEET
Zaziki	MILK
Ziegenkäse	MILK
Ziegenkeule	MEAT
Ziegenmilch	MILK
Zigeunerwurst	MEAT
Zimt	SPICE
Zimtstern	SWEET
Zimtzucker	SPICE
Zitrone	FRUIT
Zitronenaroma	SPICE
Zitronenbonbon	SWEET
Zitroneneis	SWEET
Zitronenkuchen	SWEET
Zitronenlimonade	BEVERAGE
Zitronenmelisse	SPICE
Zitronensaft	BEVERAGE
Zitronentee	BEVERAGE
Zitrusfrucht	FRUIT
Zitrusfruchtsaft	BEVERAGE
Zucchini	VEGE
Zucchini-Käse-Soße	SPICE
Zucchini-Möhren-Puffer	VEGE
Zucchini-Omelett	EGG
Zucchini-Paprika-Gemüse	VEGE
Zucchini-Paprika-Salat	VEGE
Zucchini-Pesto	SPICE
Zucchini-Schokoladenkuchen	SWEET
Zucker	SPICE
Zuckerkuchen	SWEET
Zuckermelone	FRUIT
Zuckerrohrsaft	BEVERAGE
Zuckerrübensirup	SPICE
Zuckerwatte	SWEET
Zunge	MEAT
Zwetschge	FRUIT
Zwetschgenkompott	FRUIT
Zwetschgenkuchen	SWEET
Zwetschgenschnaps	BEVERAGE
Zwetschgenwasser	BEVERAGE
Zwieback	STARCH
Zwiebel	SPICE
Zwiebelkuchen	SWEET
